11111111111111111111
1000P000000000000E01
1000000000C000000001
1000000000000000C001
11111111111111111111
