11111111111111111111
1000P000001000000001
1000000000C0000E0001
1000000000100000C001
11111111111111111111
