1111111111111111111
100P01000010A0A0001
1001000000100000001
1001000110000000E01
1000000000100000001
100C011000100000001
1000010000100000001
100C00100000000A001
1111111111111111111
