1111111111111111111
10000100001000A0001
1001000000100000001
10010P0110000000E01
1000000000100000001
100C0110001000A0001
1000010000100000001
100C0010A0000000001
1111111111111111111
