1111111111111111111
100001000010A0A0001
1001000000100000001
1001000110000000E01
1000000000100C0P001
100001100010CA0C001
1000010000100C00001
100000100000000A001
1111111111111111111
