1111111111111111111
100001000010A0A0001
1001000000100000001
1001000110000000E01
100000000010000P001
100C011000100A0C001
1000010000100000001
100C00100000000A001
1111111111111111111
