111111111111111111
100000000010000001
100000000010000001
10000P001000000E01
1000001000100000C1
1000001000100000C1
1000001000100000C1
1000001000C00000C1
1000001000100000C1
111111111111111111
