11111111111111111111
10000000001000000001
10000P0000C0000E0001
1000000000100000C001
11111111111111111111
