1111111111111111111
1000010000100000001
1001000000100000001
10010P0110000000E01
10000000001000000C1
10000110001000000C1
10000110001000000C1
1000011000C000000C1
10000010001000000C1
10000010001000000C1
1111111111111111111
